11111111111111111111111111111
1000000000111000000000111E001
1000C0C000111000C0C0001110001
10000000C01110C00000C01110C01
10C01110001110001110001110001
10001110C01110C01110C01110C01
10C01110001110001110001110001
10001110C00000C01110C00000C01
1000111000C0C000111000C0C0001
1P001110000000001110000000001
11111111111111111111111111111