111111
1000E1
10C001
100001
100001
100001
111111