   111111
  1P0000E1
 10C0000001
100000000001
 1000000001
  10000001
   111111