111111
1P00E1
10C001
000001
100001
100001
111111