111111
1P00E1
10C001
100001
100000
100001
111111