111111
1P00E1
100001
100001
100001
100001
111111