11111111111111111111111111111111111111111111111111111111111
1P00C000C000C0000000000000000000000000000000000000000000001
100000000000000C0000000000000000000000000000000000000000001
10000000000000000000000000000000000000000000000000000000001
100000000C0000000000000000000000000000000000000000000000001
10000000000000000000000000000000000000000000000000000000001
100000000000000000C0000000000000000000000000000000000000001
100000000C0000000000000000000000000000000000000000000000001
10000000000000000000000000000000000000000000000000000000001
10000000000000C00000000000000000000000000000000000000000001
1000000000C000000000000000000000000000000000000000000000001
10000000C00000000000C00000000000000000000000000000000000001
100000000C0000000000000000000000000000000000000000000000001
1000000000000000C000000000000000000000000000000000000000001
1000000000000000C0000000000000000000000000000000000000000E1
11111111111111111111111111111111111111111111111111111111111