1111111111
100011E0C1
10C0110001
1001100001
10C011C001
1000011001
1000110001
1000110001
1000110001
1000110001
1000110001
1000110001
1000110001
1000110001
1P0C000001
1111111111